#	#	#	#	#	#	#	#	#	#
#	>	.	 	.	 	#	 	.	#
#	#	#	#	#	.	#	 	#	#
#	 	.	 	#	 	.	 	.	#
#	.	#	#	#	.	#	#	#	#
#	 	.	 	.	 	.	#	.	#
#	#	#	#	#	#	 	#	 	#
#	 	.	 	.	#	.	 	.	#
#	.	 	#	 	.	 	#	 	#
#	#	#	#	 	#	#	#	#	#
#	#	#	#	 	#	#	#	#	#
